11111111111111111111
1CC1CCCCC1001000CCC1
1001000CCCCCCC100CC1
1PCCCC0001CCCC100CE1
11111111111111111111