11111111111111111111
10C0000000001000C001
1000000C000000000001
1P0000000100000000E1
11111111111111111111