111111111111111111111111111111
10C0000000001000C00000000000C1
1000000C0000000000000000000001
1P00000001000000000000000000E1
111111111111111111111111111111